{
	"tile_width": 64,	
	"map_width": 20,
	"map_height": 12,
	"background": [
		[ 23,  23,  23,  23,  23,  23,  23,  23,  23,  23,  23,  23,  23,  23,  23,  23,  23,  23,  23,  23 ],
		[ 23,  23,  23,  23,  23,  23,  23,  23,  23,  23,  23,  23,  23,  23,  23,  23,  23,  23,  23,  23 ],
		[ 46,  46,  46,  46,  46,  46,  46,   3,  23,  23,  23,  23,   2,  46,  46,  46,  46,  46,  46,  46 ],
		[  0,   0,   0,   0,   0,   0,   1,  22,  23,  23,  23,  23,  24, 298,   0,   0,   0,   0,   0,   0 ],
		[ 23,  23,  23,  23,  23,  23,  24,  22,  23,  23,  23,  23,  24,  22,  23,  23,  23,  23,  23,  23 ],
		[ 23,  23,  23,  23,  23,  23,  24,  22,  23,  23,  23,  23,  24,  22,  23,  23,  23,  23,  23,  23 ],
		[ 23,  23,  23,  23,  23,  23,  24,  22,  23,  23,  23,  23,  24,  22,  23,  23,  23,  23,  23,  23 ],
		[ 23,  23,  23,  23,  23,  23,  24,  22,  23,  23,  23,  23,  24,  22,  23,  23,  23,  23,  23,  23 ],
		[ 23,  23,  23,  23,  23,  23,  24,  45,  46,  46,  46,  46,  47,  22,  23,  23,  23,  23,  23,  23 ],
		[ 23,  23,  23,  23,  23,  23,  25,   0,   0,   0,   0,   0,   0,  26,  23,  23,  23,  23,  23,  23 ],
		[ 23,  23,  23,  23,  23,  23,  23,  23,  23,  23,  23,  23,  23,  23,  23,  23,  23,  23,  23,  23 ],
		[ 23,  23,  23,  23,  23,  23,  23,  23,  23,  23,  23,  23,  23,  23,  23,  23,  23,  23,  23,  23 ]
	],
	"enemy_path": [[[0,192], [448,192]], [[448,192], [448,576]], [[448,576], [832,576]], [[832,576], [832,192]], [[832,192], [1280,192]]],
	"enemy_start_cash": 10000,
	"enemy_cash_growth_per_tick": 25.0
}
